AATCACGAGCATTGAA	 CD8 Naive
AATCACGCAAGTCGTT	 CD8 Naive
AATCACGCACAAATCC	 CD4 TCM
AATCACGCACAGAGAC	 CD4 Naive
AATCACGCAGGGAATC	 CD4 TCM
AATCACGGTCTTCATT	 NK
AATCACGTCAGGGATG	 CD14 Mono
AATCACGTCCAATCCC	 Treg
AATCACGTCCTTCACG	 CD4 TCM
AATCACGTCGTAGAGG	 CD4 TCM
ACAGAAAAGGCCTAGA	 CD14 Mono
ACAGAAAAGGTCTACT	 CD8 TEM
ACAGAAAAGTAATTGG	 CD14 Mono
ACAGAAACAATCTCGA	 CD4 Naive
ACAGAAACACGCGCAT	 CD14 Mono
ACAGAAACAGTGTGCC	 CD14 Mono
ACAGAAAGTAGGTTTC	 CD8 TEM
ACAGAAAGTCACTCGG	 CD8 Naive
ACCCTTGAGTAGTCTC	 NK
ACCCTTGCAAGTAGTA	 CD4 TCM
ACCCTTGCAAGTCGTT	 pDC
ACCCTTGCACTACACA	 CD14 Mono
ACCCTTGCAGGGAATC	 CD14 Mono
ACCCTTGCAGTTTCGA	 CD14 Mono
ACCCTTGCATCTCCCA	 CD4 Naive
ACCCTTGTCAAGAAAC	 CD14 Mono
ACCCTTGTCTCTAGGA	 CD14 Mono
ACCCTTGTCTGTGCGG	 CD14 Mono
ACGTCCTAGGAACTCG	 CD4 TCM
ACGTCCTAGGTACAGC	 CD14 Mono
ACGTCCTAGTCATCCA	 CD4 Naive
ACGTCCTCAATCTGCA	 B intermediate
ACGTCCTCACTTCAGA	 B naive
ACGTCCTCAGACCTAT	 CD14 Mono
ACGTCCTCATCTCCCA	 NK
ACGTCCTGTGGCTTAT	 CD8 TEM
ACGTCCTTCACAAGAA	 CD8 Naive
ACGTCCTTCAGGGATG	 CD14 Mono
ACGTCCTTCGCCACTT	 CD14 Mono
ACTATTCAGACCAGAC	 CD4 Naive
ACTATTCAGTAGGAAG	 CD14 Mono
ACTATTCAGTGCGTCC	 CD8 TEM
ACTATTCAGTGTTGAA	 CD4 Naive
ACTATTCCACCAGCGT	 CD8 Naive
ACTATTCCATCCTATT	 CD14 Mono
ACTATTCGTGGCTTAT	 CD14 Mono
ACTGTGAAGGTCTACT	 CD14 Mono
ACTGTGAAGTAGGAAG	 CD8 Naive
ACTGTGACAATAGTAG	 NK
ACTGTGACACATGAAA	 Plasmablast
ACTGTGAGTGACGCCT	 CD4 TCM
ACTGTGATCCGCTTAC	 CD14 Mono
ACTGTGATCTGCCCTA	 CD4 TCM
ACTTTCAAGAGAGCGG	 MAIT
ACTTTCACAGCTGCCA	 CD8 Naive
ACTTTCACATGAATAG	 B intermediate
ACTTTCAGTCCCGTGA	 CD4 TCM
ACTTTCAGTCCTTAAG	 CD14 Mono
ACTTTCAGTGACGCCT	 CD4 TCM
ACTTTCATCCTTATCA	 Treg
ACTTTCATCTCCAATT	 CD14 Mono
AGACACTAGCCTCTGG	 CD4 Naive
AGACACTAGCGAATGC	 CD4 TCM
AGACACTAGCGACATG	 CD8 TEM
AGACACTAGGGCGAAG	 CD8 Naive
AGACACTCAATTAGGA	 CD14 Mono
AGACACTCACCGTGAC	 CD14 Mono
AGACACTCACTTCAGA	 CD14 Mono
AGACACTCATATCTGG	 CD14 Mono
AGACACTGTGACGCCT	 Treg
AGACACTGTTCGGCTG	 CD14 Mono
AGACACTTCCGAGAAG	 CD16 Mono
AGACACTTCTCTAGGA	 CD14 Mono
AGGGAGTAGAAATTGC	 CD8 Naive
AGGGAGTAGCACCTGC	 CD4 TCM
AGGGAGTAGCCTCTTC	 CD8 Naive
AGGGAGTAGGATCACG	 B naive
AGGGAGTAGGCCTAGA	 CD8 Naive
AGGGAGTAGGTACAGC	 CD4 Naive
AGGGAGTAGTAATTGG	 CD14 Mono
AGGGAGTAGTGTGTTC	 CD14 Mono
AGGGAGTCAAACCATC	 CD8 Naive
AGGGAGTCACAAATCC	 CD4 Naive
AGGGAGTCATCAGTGT	 CD14 Mono
AGGGAGTGTGATTGGG	 CD4 Naive
AGGGAGTGTGTCTAAC	 CD14 Mono
AGGGAGTTCGAACGCC	 CD14 Mono
AGGGAGTTCGTTTACT	 CD8 Naive
AGGGAGTTCTTCCTAA	 CD14 Mono
AGGGTGAAGCACTCTA	 CD8 Naive
AGGGTGAAGCTTGTTG	 CD14 Mono
AGGGTGAAGGTACAGC	 CD14 Mono
AGGGTGAAGTCCCAAT	 CD14 Mono
AGGGTGAAGTGTTGAA	 gdT
AGGGTGACAAGAGAGA	 CD8 Naive
AGGGTGACACAAATCC	 CD14 Mono
AGGGTGACAGCTACTA	 CD4 Naive
AGGGTGACATCTCCCA	 CD14 Mono
AGGGTGACATGAAGCG	 CD8 TEM
AGGGTGAGTAACGCGA	 CD4 TCM
AGGGTGAGTAGCGTAG	 gdT
AGGGTGAGTTACACAC	 CD14 Mono
AGGGTGAGTTCGAAGG	 CD14 Mono
AGGGTGAGTTGGAGGT	 pDC
AGGGTGATCAAAGGTA	 CD14 Mono
AGGGTGATCCACGTAA	 CD14 Mono
AGGGTGATCCCGTTGT	 CD8 Naive
AGGGTGATCGTCGGGT	 CD14 Mono
AGTAACCAGAGAGCGG	 B intermediate
AGTAACCAGCCTCTGG	 gdT
AGTAACCAGGTTGGAC	 CD4 TCM
AGTAACCAGTGCGTCC	 CD8 Naive
AGTAACCCAACGCATT	 CD16 Mono
AGTAACCCAGGGAATC	 CD4 TCM
AGTAACCCAGTGTGCC	 CD14 Mono
AGTAACCGTAACTTCG	 CD14 Mono
AGTAACCGTACGGGAT	 CD4 Naive
AGTAACCGTCACTCGG	 CD14 Mono
AGTAACCGTTCGAAGG	 CD8 TEM
AGTAACCTCCAACTAG	 CD8 Naive
AGTAACCTCCTGCTAC	 CD16 Mono
AGTAACCTCTAGTCAG	 CD14 Mono
AGTAACCTCTCCGAGG	 CD4 TCM
AGTAACCTCTGAATCG	 CD14 Mono
AGTAGTCAGATACCAA	 CD14 Mono
AGTAGTCAGGCGTTAG	 CD14 Mono
AGTAGTCAGGCTCAAG	 CD8 TEM
AGTAGTCAGTCCCAAT	 CD14 Mono
AGTAGTCAGTGTGTTC	 CD14 Mono
AGTAGTCGTAACTTCG	 CD8 Naive
AGTAGTCGTCACTCGG	 CD4 TCM
AGTAGTCGTCCCGGTA	 CD8 Naive
AGTAGTCGTCCTTAAG	 CD14 Mono
AGTAGTCGTCGAATGG	 CD4 Naive
AGTAGTCGTGACGCCT	 B naive
AGTAGTCTCAAAGGTA	 CD8 Naive
AGTAGTCTCGCCACTT	 CD14 Mono
AGTAGTCTCTGCCCTA	 CD4 TCM
AGTGACTAGCATTGAA	 CD8 TEM
AGTGACTAGCTTGTTG	 CD14 Mono
AGTGACTAGGTTACAA	 CD14 Mono
AGTGACTCACACCGCA	 CD8 TEM
AGTGACTCACCCTCTA	 CD8 Naive
AGTGACTCACTTCAGA	 CD4 TCM
AGTGACTCATCAGTGT	 CD14 Mono
AGTGACTGTAATGCTC	 CD14 Mono
AGTGACTGTCAAGCGA	 CD14 Mono
AGTGACTGTGGCTTAT	 CD14 Mono
AGTGACTTCCTGCTAC	 CD14 Mono
AGTGACTTCGACGCGT	 CD16 Mono
AGTGACTTCGCGGTAC	 CD14 Mono
AGTGACTTCGTTCCTG	 CD14 Mono
AGTGACTTCTAGTCAG	 CD14 Mono
AGTGACTTCTCCGAGG	 B naive
AGTGACTTCTGGCTGG	 CD8 Naive
ATGAGTCAGGTTACAA	 CD8 Naive
ATGAGTCAGTAATTGG	 B naive
ATGAGTCCAAGTAGTA	 CD4 TCM
ATGAGTCCACAGAGAC	 CD4 Naive
ATGAGTCCAGGTTCAT	 CD14 Mono
ATGAGTCCATATCTGG	 Platelet
ATGAGTCCATTATGCG	 CD4 TCM
ATGAGTCGTGATTGGG	 CD14 Mono
ATGAGTCGTGGCTTAT	 CD8 Naive
ATGAGTCTCAAGAAAC	 B naive
ATGAGTCTCATCGCTC	 CD8 Naive
ATGAGTCTCCAACTAG	 CD14 Mono
ATGAGTCTCTGAATCG	 CD16 Mono
CACAGATCAAGAGTAT	 CD4 Naive
CACAGATCAGACCTAT	 B naive
CACAGATCAGCTGCCA	 B naive
CACAGATCAGGGAATC	 CD14 Mono
CACAGATGTACTGAGG	 CD8 Naive
CACAGATGTAGAATGT	 CD16 Mono
CACAGATGTATGAGCG	 CD8 TEM
CACAGATGTATGCGTT	 CD14 Mono
CACAGATGTTCGGCTG	 CD14 Mono
CACAGATTCGAACGCC	 CD8 TEM
CACAGATTCGCCCAGA	 CD14 Mono
CAGCAGCAGATGCTTC	 CD14 Mono
CAGCAGCAGCATTGAA	 CD4 TCM
CAGCAGCAGCGAATGC	 Treg
CAGCAGCAGGTTGCCC	 CD4 Naive
CAGCAGCCACATGAAA	 NK
CAGCAGCCACCGTGAC	 CD14 Mono
CAGCAGCCATCTCCCA	 CD4 Naive
CAGCAGCGTACGGGAT	 CD14 Mono
CAGCAGCGTAGTGTGG	 CD4 TCM
CAGCAGCGTCCCGTGA	 CD14 Mono
CAGCAGCGTCGGTGTC	 CD14 Mono
CAGCAGCGTGACAGGT	 CD14 Mono
CAGCGTGAGCATTGAA	 CD14 Mono
CAGCGTGCAATCAAGA	 CD8 Naive
CAGCGTGCATGTTCGA	 CD4 Naive
CAGCGTGGTTACACAC	 B intermediate
CAGCGTGGTTAGGAGC	 NK
CAGCGTGGTTCCACGG	 CD4 TCM
CAGCGTGTCATGCCCT	 NK
CAGCGTGTCTAGTCAG	 CD14 Mono
CAGCGTGTCTTAGCAG	 cDC2
CAGGCCAAGCATTGAA	 CD8 Naive
CAGGCCAAGCTGGTGA	 CD4 TCM
CAGGCCACACAAATCC	 CD8 Naive
CAGGCCACATCAGTGT	 CD8 Naive
CAGGCCATCCGCTTAC	 CD4 Naive
CATACAGAGCAATTAG	 CD8 TEM
CATACAGAGCGACATG	 CD14 Mono
CATACAGAGGCTCAAG	 CD14 Mono
CATACAGAGTGTTGAA	 CD14 Mono
CATACAGCAATCTGCA	 CD14 Mono
CATACAGCAGACCTAT	 CD4 TCM
CATACAGCAGGGAATC	 CD8 Naive
CATACAGCATGAAGCG	 CD14 Mono
CATACAGGTCCTTAAG	 CD4 TCM
CATACAGGTCTTCATT	 pDC
CATACAGGTGCACAAG	 CD4 Naive
CATACAGGTGTCTAAC	 CD14 Mono
CATACAGGTTCGAAGG	 CD8 TEM
CATACAGTCCATTGCC	 CD14 Mono
CATACAGTCGTTCCTG	 CD4 TCM
CATACAGTCTCCAATT	 CD14 Mono
CATACAGTCTTAGCCC	 CD8 TEM
CCCTCTCAGCAATTAG	 CD4 TCM
CCCTCTCAGGTTACAA	 CD8 Naive
CCCTCTCCAATCTCGA	 CD14 Mono
CCCTCTCCAGGTTCAT	 CD16 Mono
CCCTCTCGTAGTGTGG	 CD8 Naive
CCCTCTCGTCCACACG	 CD4 Naive
CCCTCTCGTCCCGGTA	 CD4 Naive
CCCTCTCGTGCACAAG	 CD4 Naive
CCCTCTCTCGTCGGGT	 NK
CGGCAGTAGGAACTCG	 CD14 Mono
CGGCAGTAGGTTACAA	 CD16 Mono
CGGCAGTAGTATAACG	 CD14 Mono
CGGCAGTCAAGTAGTA	 B intermediate
CGGCAGTCACTACGGC	 cDC2
CGGCAGTCAGTTTCGA	 CD8 Naive
CGGCAGTCATATCTGG	 CD14 Mono
CGGCAGTGTCCACACG	 CD4 Naive
CGGCAGTGTTAAGTCC	 B naive
CGGCAGTGTTACACAC	 CD4 Naive
CGGCAGTGTTGGAGGT	 CD14 Mono
CGGCAGTTCCACGTAA	 CD4 TCM
CGTCCATAGCCTCTTC	 CD4 Naive
CGTCCATAGTAGTCTC	 CD4 Naive
CGTCCATCAGCTGCCA	 B naive
CGTCCATGTAGGTTTC	 B memory
CGTCCATGTATGAGCG	 CD14 Mono
CGTCCATGTCCACACG	 CD14 Mono
CGTCCATTCAGGGATG	 CD14 Mono
CGTCCATTCCTTATCA	 CD14 Mono
CGTCCATTCGCCCAGA	 CD8 TEM
CGTCCATTCTCGAGTA	 CD14 Mono
CGTCCATTCTTAGCCC	 CD14 Mono
GAGGGTAAGACGTCCC	 CD14 Mono
GAGGGTAAGCTCTGTA	 CD14 Mono
GAGGGTAAGTGTTGAA	 NK
GAGGGTACAACCAATC	 cDC2
GAGGGTACAATCTGCA	 CD4 Naive
GAGGGTACACCCTCTA	 B intermediate
GAGGGTACATGGCTAT	 gdT
GAGGGTAGTATACCTG	 CD14 Mono
GAGGGTAGTCACGCTG	 CD4 Naive
GAGGGTATCCGAGAAG	 NK
GAGTTGTAGCTTGTTG	 B naive
GAGTTGTCAATCAAGA	 CD14 Mono
GAGTTGTCAATTAGGA	 NK
GAGTTGTCAGACCTAT	 CD14 Mono
GAGTTGTCAGGGAATC	 CD14 Mono
GAGTTGTCATTATGCG	 B naive
GAGTTGTGTAACGCGA	 B intermediate
GAGTTGTGTATACCTG	 CD4 Naive
GAGTTGTGTCCACACG	 CD8 Naive
GAGTTGTGTCCCGGTA	 CD14 Mono
GAGTTGTGTTAAGACA	 CD8 Naive
GAGTTGTGTTAAGTCC	 CD8 Naive
GAGTTGTTCAAAGGTA	 gdT
GAGTTGTTCAAGAAAC	 B naive
GAGTTGTTCCATTGCC	 CD16 Mono
GAGTTGTTCCTGCTAC	 CD8 Naive
GAGTTGTTCGTCGGGT	 CD4 Naive
GAGTTGTTCTCCAATT	 NK
GAGTTGTTCTCTAGGA	 NK
GCGTTTCAGACCATTC	 CD4 TCM
GCGTTTCAGGATCACG	 CD8 TEM
GCGTTTCCAAGTAGTA	 CD4 TCM
GCGTTTCCAGCAGTGA	 CD4 Naive
GCGTTTCGTCCTTAAG	 CD4 Naive
GCGTTTCGTTAGGAGC	 CD8 Naive
GCGTTTCGTTCCGTTC	 CD4 Naive
GCGTTTCGTTGGAGGT	 CD4 Naive
GCGTTTCTCCCGTTGT	 gdT
GCGTTTCTCCGAGAAG	 gdT
GCGTTTCTCCTTATCA	 CD14 Mono
GGTAACTAGCATTGAA	 CD16 Mono
GGTAACTAGGCCTAGA	 CD14 Mono
GGTAACTAGTGTGTTC	 B memory
GGTAACTCAAGTCGTT	 CD14 Mono
GGTAACTCACGCGCAT	 CD4 Naive
GGTAACTCATGAAGCG	 CD4 Naive
GGTAACTCATGGCTAT	 NK Proliferating
GGTAACTGTAACTTCG	 CD8 Naive
GGTAACTGTACGGGAT	 CD4 Naive
GGTAACTGTCACTCGG	 CD14 Mono
GGTAACTGTCCACACG	 CD4 TCM
GGTAACTGTTCGGCTG	 CD14 Mono
GGTAACTTCCCAACTC	 CD4 Naive
GGTAACTTCTGCCCTA	 CD8 Naive
GGTAACTTCTTAGCAG	 CD4 TCM
GGTAATCAGAAATTGC	 CD14 Mono
GGTAATCAGCTTGTTG	 CD4 TCM
GGTAATCAGGTTGCCC	 CD14 Mono
GGTAATCAGTAGTCTC	 CD8 Naive
GGTAATCAGTATAACG	 CD4 Naive
GGTAATCCACCCTCTA	 CD4 TCM
GGTAATCCATGGCTAT	 CD8 Naive
GGTAATCGTGCGGTAA	 CD14 Mono
GGTAATCGTTAAGTCC	 CD4 Naive
GGTAATCTCATTTGGG	 CD4 Naive
GGTAATCTCGCCCAGA	 CD8 Naive
GGTAATCTCTAGTCAG	 CD4 TCM
GTCAAGTAGCTCTGTA	 CD14 Mono
GTCAAGTAGGAACTCG	 CD14 Mono
GTCAAGTAGTCTTGGT	 CD8 Naive
GTCAAGTCAAGTAGTA	 MAIT
GTCAAGTCACTTCAGA	 CD14 Mono
GTCAAGTGTAATGCTC	 CD4 TCM
GTCAAGTGTATGAGCG	 CD4 TCM
GTCAAGTTCATGCCCT	 CD14 Mono
GTCAAGTTCCGCACGA	 CD4 TCM
GTCAAGTTCCGTATGA	 B naive
GTCAAGTTCGCCCAGA	 CD4 TCM
GTGAGCCAGCCTCTGG	 CD14 Mono
GTGAGCCAGGAACTCG	 NK
GTGAGCCCAATTAGGA	 CD14 Mono
GTGAGCCCACTATGTG	 CD4 Naive
GTGAGCCCATATCTGG	 CD14 Mono
GTGAGCCGTAGTGTGG	 CD8 Naive
GTGAGCCGTATGCGTT	 cDC2
GTGAGCCGTCCCGTGA	 CD14 Mono
GTGAGCCGTGTCTAAC	 CD14 Mono
GTGAGCCTCGTTCCTG	 CD8 Naive
GTGAGCCTCGTTTACT	 cDC2
GTGAGCCTCTCGAGTA	 CD14 Mono
GTGGAGAAGATCGCCC	 CD8 Naive
GTGGAGAAGGCTCAAG	 CD16 Mono
GTGGAGAAGGTTACAA	 MAIT
GTGGAGAAGTAATTGG	 CD8 Naive
GTGGAGACACCCTCTA	 CD8 Naive
GTGGAGACATGAAGCG	 CD14 Mono
GTGGAGAGTATGAGCG	 B naive
GTGGAGAGTCAAGCCC	 cDC2
GTGGAGATCCGGACGT	 CD14 Mono
GTGGAGATCCTACAAG	 CD14 Mono
GTGGAGATCGTTTACT	 CD4 Naive
GTGGAGATCTTCCTAA	 CD4 TCM
GTGTGGCAGCATTGAA	 CD14 Mono
GTGTGGCAGGCGTTAG	 CD14 Mono
GTGTGGCAGGTCTACT	 B memory
GTGTGGCAGTCCCAAT	 CD4 TCM
GTGTGGCCAATAGTAG	 CD14 Mono
GTGTGGCGTAACTTCG	 NK
GTGTGGCGTACGGGAT	 CD4 TCM
GTGTGGCGTTCCGTTC	 B naive
GTGTGGCTCAAAGGTA	 CD4 Naive
GTGTGGCTCGCCTTGT	 CD14 Mono
GTGTGGCTCGTCGGGT	 CD14 Mono
TAACACGCACCCTCTA	 CD8 TEM
TAACACGCATGAAGGC	 CD4 Naive
TAACACGGTCACTCGG	 pDC
TAACACGGTCGGTGTC	 CD4 Naive
TAACACGGTTGGGATG	 MAIT
TAACACGTCAATCCAG	 CD8 TEM
TAACACGTCCAACTAG	 CD4 Naive
TAGGAGGAGCCTCTTC	 NK
TAGGAGGAGGAACTCG	 CD14 Mono
TAGGAGGAGGATCACG	 CD4 Naive
TAGGAGGAGGCTCAAG	 CD14 Mono
TAGGAGGAGTAGTCTC	 CD14 Mono
TAGGAGGCAAGAGTAT	 CD4 Naive
TAGGAGGCACATGAAA	 CD14 Mono
TAGGAGGCAGACCTAT	 CD14 Mono
TAGGAGGCATGGCTAT	 CD14 Mono
TAGGAGGGTATACCTG	 CD14 Mono
TAGGAGGGTCCACACG	 CD4 TCM
TAGGAGGGTGGCTTAT	 CD14 Mono
TAGGAGGGTTCCGTTC	 CD16 Mono
TAGGAGGTCTCCAATT	 CD8 Naive
TATTGCTAGAGAGCGA	 CD14 Mono
TATTGCTAGAGAGCGG	 CD14 Mono
TATTGCTAGCGAATGC	 CD8 Naive
TATTGCTAGCTCTGTA	 CD14 Mono
TATTGCTAGTAGGAAG	 CD4 TCM
TATTGCTAGTAGTCTC	 CD4 Naive
TATTGCTAGTCCCAAT	 B naive
TATTGCTCACACCGCA	 B naive
TATTGCTCACAGAGAC	 CD8 Proliferating
TATTGCTCACATGAAA	 CD4 Naive
TATTGCTCACTACACA	 CD16 Mono
TATTGCTCAGCAGTGA	 CD4 TCM
TATTGCTCAGCTACTA	 CD14 Mono
TATTGCTCATCTCCCA	 NK
TATTGCTGTAGAATGT	 CD4 Naive
TATTGCTTCCATTGCC	 CD4 TCM
TATTGCTTCCTACAAG	 CD14 Mono
TCACGCTAGACGTCGA	 CD8 Naive
TCACGCTCAATCAAGA	 CD8 TEM
TCACGCTCATGAATAG	 CD14 Mono
TCACGCTGTGCCTTCT	 CD8 TEM
TCACGCTTCCTTCACG	 CD8 Naive
TCACGCTTCGTCGGGT	 CD8 TEM
TCACGCTTCGTTCCTG	 CD14 Mono
TCACGCTTCTCCGAGG	 CD4 TCM
TCCAGAAAGCTCACTA	 B intermediate
TCCAGAAAGTAGTCTC	 gdT
TCCAGAAAGTGTGTTC	 CD14 Mono
TCCAGAACACTACCGG	 NK
TCCAGAACAGCAGTGA	 CD4 TCM
TCCAGAAGTAGGTTTC	 CD4 Naive
TCCAGAAGTCAAGCCC	 CD4 Naive
TCCAGAAGTCAAGCGA	 CD4 TCM
TCCAGAATCGTTTACT	 CD8 TEM
TCCAGAATCTGTGCGG	 CD4 Naive
TCGAAGTAGACGTCGA	 CD14 Mono
TCGAAGTAGGGAGGTG	 gdT
TCGAAGTGTACTGAGG	 CD14 Mono
TCGAAGTGTAGGTTTC	 CD8 Naive
TCGAAGTGTCTAGGTT	 cDC2
TCGAAGTGTGTCTAAC	 B intermediate
TCGAAGTTCCAATCCC	 CD4 TCM
TCGAAGTTCCCGTTGT	 CD4 Naive
TCGAAGTTCCGGACGT	 CD8 Naive
TCGCTCAAGTAATTGG	 CD8 Naive
TCGCTCACACAAATCC	 MAIT
TCGCTCAGTACGGGAT	 CD14 Mono
TCGCTCAGTGGCTTAT	 CD4 Naive
TCGCTCATCTCCAATT	 CD14 Mono
TGCTCGTAGCTGGTGA	 B intermediate
TGCTCGTAGGGCGAAG	 CD4 TCM
TGCTCGTAGTATAACG	 CD14 Mono
TGCTCGTAGTGGCCTC	 CD4 Naive
TGCTCGTCAAATGCGG	 CD16 Mono
TGCTCGTCAACGCATT	 CD8 Naive
TGCTCGTGTATAGGAT	 CD4 TCM
TGCTCGTGTCCTTAAG	 CD4 Naive
TGCTCGTGTCTAGGTT	 CD14 Mono
TGCTCGTGTGACAGGT	 CD4 TCM
TGCTCGTGTTCCGTTC	 CD4 Naive
TGGTACAAGCATTGAA	 CD8 Naive
TGGTACAAGCGACATG	 CD4 Naive
TGGTACAAGGATCACG	 CD4 TCM
TGGTACAAGGGCGAAG	 CD14 Mono
TGGTACAAGGTACAGC	 CD8 Naive
TGGTACAAGGTTGCCC	 CD4 TCM
TGGTACAAGTCCCAAT	 CD4 TCM
TGGTACACAAATGCGG	 CD4 Naive
TGGTACACAATCTGCA	 CD4 TCM
TGGTACACATCCTATT	 CD14 Mono
TGGTACACATTATGCG	 CD14 Mono
TGTCCTGAGACGTCCC	 CD14 Mono
TGTCCTGCACACCGCA	 B naive
TGTCCTGCAGGGAATC	 CD8 TEM
TGTCCTGGTAACTTCG	 CD4 TCM
TGTCCTGGTTCCGTTC	 CD4 TCM
TGTGATGAGACCAGAC	 B naive
TGTGATGAGCACTCTA	 B intermediate
TGTGATGAGGAACTCG	 NK
TGTGATGAGGTACAGC	 gdT
TGTGATGGTAGGTTTC	 B naive
TGTGATGGTGACAGGT	 CD4 Naive
TGTGATGTCCGAGAAG	 NK
TGTGATGTCGTAGAGG	 Treg
TGTGATGTCTTAGCAG	 CD14 Mono
TGTGATGTCTTCCTAA	 CD4 TCM
TTACAGGAGAAATTGC	 CD14 Mono
TTACAGGAGAGAGCGA	 CD14 Mono
TTACAGGAGAGAGCGG	 CD14 Mono
TTACAGGAGGAACTCG	 CD8 Naive
TTACAGGAGTCCCAAT	 CD14 Mono
TTACAGGCAAATGCGG	 CD14 Mono
TTACAGGCACCGTGAC	 CD4 TCM
TTACAGGCATCTCCCA	 CD4 TCM
TTACAGGGTCAAGCGA	 CD4 Naive
TTACAGGGTTAAGTCC	 CD14 Mono
TTACAGGGTTACACAC	 B naive
TTACAGGGTTAGGAGC	 CD16 Mono
TTACAGGTCTAGTCAG	 CD14 Mono
TTACAGGTCTCGAGTA	 CD8 TEM
TTCGATTAGCACCTGC	 CD16 Mono
TTCGATTAGCTGGTGA	 CD8 TEM
TTCGATTAGGCCTAGA	 CD8 Naive
TTCGATTAGTGTGTTC	 B naive
TTCGATTCAAGCCATT	 MAIT
TTCGATTCAATCAAGA	 CD4 TCM
TTCGATTCAGTGTGCC	 CD4 TCM
TTCGATTGTAACTTCG	 CD4 TCM
TTCGATTGTATGAGCG	 B memory
TTCGATTGTCGTATGT	 NK
TTCGATTTCACAAGAA	 CD14 Mono
TTCGATTTCCACGTAA	 CD14 Mono
TTCGATTTCCTACAAG	 CD14 Mono
TTGTTTGAGCCTCTTC	 CD4 Naive
TTGTTTGAGGGAGGTG	 CD16 Mono
TTGTTTGAGGTACAGC	 CD14 Mono
TTGTTTGAGGTTACAA	 B intermediate
TTGTTTGAGGTTGCCC	 CD14 Mono
TTGTTTGCAATTAGGA	 CD4 Naive
TTGTTTGGTAATGCTC	 CD4 Naive
TTGTTTGGTAGTGTGG	 CD4 TCM
TTGTTTGGTCCTTAAG	 CD14 Mono
TTGTTTGGTGCACAAG	 CD14 Mono
TTGTTTGGTTAAGCAA	 cDC2
TTGTTTGTCATTTGGG	 CD4 TCM
TTGTTTGTCGCCTTGT	 CD4 TCM
TTGTTTGTCTCGAGTA	 CD8 Naive
TTTCATGAGCTGGTGA	 CD4 TCM
TTTCATGAGGTCTACT	 CD14 Mono
TTTCATGAGGTTGCCC	 CD14 Mono
TTTCATGCAAGAGTAT	 CD8 TEM
TTTCATGCACACCGCA	 CD4 TCM
TTTCATGCACGCGCAT	 CD14 Mono
TTTCATGGTCGTATGT	 CD8 TCM
TTTCATGGTGCACAAG	 CD14 Mono
TTTCATGGTTGGAGGT	 CD14 Mono
TTTCATGTCAATCCAG	 CD4 Naive
TTTCATGTCTCGAGTA	 CD14 Mono
TTTCGATAGACCATTC	 CD16 Mono
TTTCGATAGCACTCTA	 CD4 TCM
TTTCGATAGTGCGTCC	 CD14 Mono
TTTCGATCAAGTCGTT	 CD14 Mono
TTTCGATCATCCTTCG	 CD4 Naive
TTTCGATGTAACGCGA	 CD4 Naive
TTTCGATGTATGAGCG	 CD14 Mono
TTTCGATGTGACGCCT	 CD14 Mono
TTTCGATTCCACGTAA	 CD14 Mono
TTTCGATTCCTGCTAC	 CD16 Mono
TTTCGATTCGTCGGGT	 NK
TTTGTTGAGCGAATGC	 CD4 Naive
TTTGTTGAGGATCACG	 CD4 TCM
TTTGTTGAGTGGCCTC	 B naive
TTTGTTGCAATCAAGA	 CD16 Mono
TTTGTTGCACAGAGAC	 CD4 Naive
TTTGTTGCACTTCAGA	 NK
TTTGTTGGTCCACACG	 CD14 Mono
TTTGTTGGTGCGGTAA	 B naive
TTTGTTGGTGGCTTAT	 CD14 Mono
TTTGTTGTCATTTGGG	 CD8 TEM
TTTGTTGTCCAACTAG	 MAIT
TTTGTTGTCTCTAGGA	 CD14 Mono
